--------------------------------------------
--------------------------------------------
--------------------------------------------
-##########################################-
-#                                        #-
-#    ###  #    #  ####  ###  #      #    #-
-#         #    #             ###  ###    #-
-g    ###  #  ###  ####  ###  #      #    d-
-#         #    #             #      #    #-
-#    ###  #    #  ####  ###  #      #    #-
-#                                        #-
-##########################################-
--------------------------------------------
