--------------------------------------------
--------------------------------------------
--------------------------------------------
-##########################################-
-#                                        #-
-#                                        #-
-#                                        #-
-#                                        #-
-#                                        #-
-#                                        #-
-g            #                           d-
-#                                        #-
-#                                        #-
-#                           #            #-
-#                                        #-
-#                                        #-
-##########################################-
--------------------------------------------
--------------------------------------------
