-----------------------------------------------
-----------------------------------------------
-----------------------------------------------
-#############################################-
-#                                           #-
-#                                           #-
-#                     #                     #-
-#                                           #-
-#                                           #-
-#                                           #-
-g         #                                 d-
-#                                           #-
-#                                           #-
-#                            #              #-
-#                                           #-
-#                                           #-
-#############################################-
-----------------------------------------------
-----------------------------------------------
